外TM员工名称TM脉-->外周静脉
扩TM员工名称TM脉-->扩张静脉
肌TM员工名称TM-->肌张力
曲TM员工名称TM脉-->曲张静脉
大TM员工名称TM能-->大于可能
反TM员工名称TM-->反应可
伤口TM员工名称TM适中-->伤口张力适中
起病即刻达到TM员工名称TM-->起病即刻达到高峰
TM员工名称TM期居住-->曾长期居住
TM员工名称TM醇-->甘露醇
检TM员工名称TM确-->检查明确
TM员工名称TM溪-->朱丹溪
治疗TM员工名称TM-->治疗无效
TM员工名称TM发育期-->青春发育期
由TM员工名称TM脉血栓栓塞症的发-->由于静脉血栓栓塞症的发
脐TM员工名称TM脉-->脐周静脉
多见TM员工名称TM-->多见于青
常见TM员工名称TM-->常见于青
发TM员工名称TM壮-->发于青壮
TM员工名称TM期-->青春期
全麻TM员工名称TM-->全麻苏醒
TM员工名称TM延迟-->苏醒延迟
麻醉TM员工名称TM-->麻醉苏醒
TM员工名称TM区-->徐汇区
多TM员工名称TM春期-->多于青春期
对TM员工名称TM能-->对于可能
升TM员工名称TM显-->升高明显
异TM员工名称TM动-->异常波动
由TM员工名称TM供-->由于可供
肛TM员工名称TM肿-->肛周红肿
低TM员工名称TM均-->低于平均
无扭转，无TM员工名称TM-->无扭转，无张力
TM员工名称TM霉素-->罗红霉素
口服磺脲类药物TM员工名称TM-->口服磺脲类药物无效
肌强直重TM员工名称TM止-->肌强直重于静止
略TM员工名称TM倾-->略向前倾
主TM员工名称TM见-->主任意见
发生TM员工名称TM春-->发生于青春
中医药大学附属TM员工名称TM中西医-->中医药大学附属岳阳中西医
就诊TM员工名称TM省-->就诊于江苏省
TM员工名称TM清醒时段-->白天清醒时段
小便次数TM员工名称TM-->小便次数白天
起源TM员工名称TM滑-->起源于平滑
升TM员工名称TM因-->升高原因
扩TM员工名称TM能-->扩张可能
曲霉菌半乳TM员工名称TM聚糖检测-->曲霉菌半乳甘露聚糖检测
附属TM员工名称TM夫医院-->附属邵逸夫医院
TM员工名称TM安区-->于静安区
TM员工名称TM兴市-->于嘉兴市
13TM员工名称TM医院-->13于明珠医院
TM员工名称TM大学附属医院-->于江苏大学附属医院
TM员工名称TM性气胸-->张力性气胸
欧TM员工名称TM-->欧唐静
泮立TM员工名称TM滴-->泮立苏静滴
腹腔镜下无TM员工名称TM疝修-->腹腔镜下无张力疝修
扩TM员工名称TM显-->扩张明显
小便色TM员工名称TM澈-->小便色黄清澈
TM员工名称TM时段-->白天时段
发TM员工名称TM少年-->发于青少年
已TM员工名称TM-->已苏醒
TM员工名称TM房子-->于红房子
宁波TM员工名称TM利-->宁波李惠利
TM员工名称TM利医院-->李惠利医院
姜TM员工名称TM热散结-->姜黄清热散结
发TM员工名称TM年-->发于青年
就诊TM员工名称TM波市-->就诊于宁波市
用中药调理后TM员工名称TM-->用中药调理后无效
TM员工名称TM疼痛不明显-->白天疼痛不明显
四肢末梢TM员工名称TM-->四肢末梢温暖
TM员工名称TM容易引起出血-->未使用容易引起出血
标本将被送TM员工名称TM-->标本将被送病理科
标本遂送至TM员工名称TM-->标本遂送至病理科
TM员工名称TM会诊-->故可行病理科会诊
弥漫TM员工名称TM克样-->弥漫马赛克样
TM员工名称TM嗜睡-->白天嗜睡
TM员工名称TM春期-->于青春期
后TM员工名称TM为-->后查明为
过程中TM员工名称TM变动-->过程中自行变动
一般TM员工名称TM经-->一般于月经
TM员工名称TM可能要求再次缴费-->病理科可能要求再次缴费
充分TM员工名称TM牵拉软腭后-->充分向前牵拉软腭后
患者TM员工名称TM安返-->患者苏醒安返
术后TM员工名称TM良好-->术后苏醒良好
TM员工名称TM它试验-->李凡它试验
TM员工名称TM充分牵拉-->向前充分牵拉
明显TM员工名称TM呼吸困难-->明显白天呼吸困难
达美TM员工名称TM片-->达美康一片
用TM员工名称TM切-->用于可切
患者TM员工名称TM无发热，偶有咳痰-->患者白天无发热，偶有咳痰
低TM员工名称TM检-->低于可检
TM员工名称TM瞌睡-->白天瞌睡
TM员工名称TM病情变化-->TM员工名称TM 病情变化
建议患者TM员工名称TM治疗-->建议患者住院手术治疗
可达疾病TM员工名称TM-->可达疾病高峰
患者体温TM员工名称TM较前下降-->患者体温高峰较前下降
未满一月TM员工名称TM安维汀-->未满一月未使用安维汀
未触及，四肢TM员工名称TM-->未触及，四肢温暖
TM员工名称TM平均血压-->白天平均血压
下肢TM员工名称TM偏高。四肢腱反射-->下肢张力偏高。四肢腱反射
到达TM员工名称TM-->到达高峰
美罗TM员工名称TM案-->美罗华方案
常发生于TM员工名称TM-->常发生于白天
四肢TM员工名称TM可-->四肢张力可
四肢肌力TM员工名称TM不配合-->四肢肌力检查不配合
少TM员工名称TM高信号-->少许中高信号
针刺觉TM员工名称TM患者-->针刺觉检查患者
四肢活动好，肛TM员工名称TM-->四肢活动好，肛周红
吻合口通畅，无TM员工名称TM-->吻合口通畅，无张力
2HzTM员工名称TM-->2Hz查明
100HzTM员工名称TM-->100Hz查明
促胰岛素分泌剂TM员工名称TM-->促胰岛素分泌剂无效
5月22日食用TM员工名称TM后自觉反酸-->5月22日食用杨梅后自觉反酸
TM员工名称TM右侧IPG-->右侧IPG
直肠癌TM员工名称TM壁-->直肠癌向前壁
院内感染TM员工名称TM-->院内感染病理科
临时TM员工名称TM导线-->临时导线
术后TM员工名称TM电阻-->术后电阻